#######################
#*..5..-#-.#........@.#
#...#...#..5.......#1.#
#####4######...#...##.#
#..2#.....##...#......#
#4###....../.......####
#.....1#...#......5..##
#..#...#...#.....#2...#
####.......#....####..#
#+./......###..4......#
#######################