#################
#@....#...../...#
#.#.#.#.#.#####.#
#.#.#.#1#.#...#.#
#.#.#.###.#.#.#.#
#.#.#.....#.#.#+#
#.#.#.#####.#.###
#1#.#.#....4#...#
###.#.#.#######.#
#..4#.#...#....-#
#.#######.#.#####
#.#.....#.#2#*..#
#.#.###.#.#####.#
#.#.#1#...#...#.#
#.#.#.#####.#.#.#
#..4.......5#...#
#################