#################
#....+#..-#.....#
#.#####.#.#.###.#
#.#.....#.#*#...#
#/#.#####.###.###
#.#....4#..2#..5#
#.#####.#######.#
#.....#.#...###.#
#.###.#.#.#.###.#
#..1#.#...#.###.#
#####.#####.#1.4#
#@........#.###.#
#1#######..4....#
#################
